########
#******#
#******#
#*PICB*#
####*###
#*****##
##**####
#****p*#
########