############
#*******%**#
#*#####*####
#**#****p**#
#**#########
#+*###PICB##
############