0000000000000w0000000000000
0d________________________0
0_00_0_0000000000000_0_00_0
0___P0_______________0P___0
0_0000_000_00000_000_0000_0
0______000_______000______0
0_0_00_____00_00_____00_0_0
0_0_00_0_0_0BIC0_0_0_00_0_0
w_0____0_0_0_p_0_0_0____0_w
0_0_00_0_0_0___0_0_0_00_0_0
0_0_00_____00_00_____00_0_0
0______000_______000______0
0_0000_000_00000_000_0000_0
0___P0_______________0P___0
0_00_0_0000000000000_0_00_0
0_________________________0
0000000000000w0000000000000