############
#*******%**#
#*#####*####
#*#*****p**#
#*#*#*######
#+****#ICBP#
############