#############w##############
#*****%*************%*****##
#*##*#*#############*#*##*##
#****#***************#****##
#*####*###*#####*###*####*##
#******###****%**###******##
#*#*##**+**##*##*****##*#*#*
#*#*##*#*#*#***#*#*#*##*#*#*
#*#****#*#*#***#*#*#****#*w*
#*#*##*#*#*#***#*#*#*##*#*##
#*#*##*****##*##*****##*#*##
#******###*******###******##
#*####*###*#####*###*####*##
#****#****%**********##***##
#*##*#*#############*#*##*##
#********%****************##
############################
############################
############################
############################