#############w##############
#*************************##
#*##*#*#############*#*##*##
#****#***************#****##
#*####*###*#####*###*####*##
#******###*******###******##
#*#*##*****##*##*****##*#*##
#*#*##*#*#*#***#*#*#*##*#*##
#*#****#*#*#***#*#*#****#*w#
#*#*##*#*#*#***#*#*#*##*#*##
#*#*##*****##*##*****##*#*##
#******###*******###******##
#*####*###*#####*###*####*##
#****#***************##***##
#*##*#*#############*#*##*##
#*************************##
############################
############################
############################
############################