#########################
#******%****************#
#*##########*######*#####
#**********#*****#******#
##########*#*##########*#
#**********#*********%**#
#*############*####*#####
#*****#**********#******#
#*###*###*############*##
#*******#****+**********#
#######*#*######*###*####
#*******#*********#*****#
#**######*********#*****#
#****#**#**PICB***#*****#
#***##**############*####
#***#**********#********#
#####**####**#########*##
#*************p*********#
#**#*###*###*############
#**#*****#*********%****#
#**#######*##*########*##
#********#**#******#****#
######*####*#####**#*####
#**%**********#*********#
#########################